XXXXXXXXXXXXXXXXXXXXXXXXXXXXXXXXXXXXXXXX
X     X     X X           X X         XX
XXX XXXXX X X X XXXXXXX XXXXX XXX X X XX
X       X           X           X X    X
X X XXXXXXX X XXXXXXXXXXX XXXXXXX XXX XX
X X X         X       X X X   X   X    X
XXX XXX X X XXX XXXXX X X XXXXX X X XXXX
X   X X   X X           X X   X X X X  X
XXX X X XXX XXX XXXXX XXX X X XXXXX XXXX
X   X X X X     X   X X     X   X X    X
XXXXXXXXXXX XXX XXX XXXXX XXX XXXXXXX XX
X X   X X             X   X X X   X X  X
X XXXXX X XXXXXXX XXXXX X XXX X X X X XX
X         X X X X X X X   X X   X      X
X                                      X
XXXXXXXXXXXXXXXXXXXXXXXXXXXXXXXXXXXXXXXX
